maze = [
    '|||||||||||||||||||||||||||',
    '|............|............|',
    '|.||||.|||||.|.|||||.||||.|',
    '|.||||.|||||.|.|||||.||||.|',
    '|.........................|',
    '|.||||.||.|||||||.||.||||.|',
    '|......||....|....||......|',
    '|.||||.||||| | |||||.||||.|',
    '|.||||.||         ||.||||.|',
    '|.||||.||  |||||  ||.||||.|',
    '      .    |EEE|    .      ',
    '|.||||.||  |||||  ||.||||.|',
    '|.||||.||         ||.||||.|',
    '|.||||.||.|||||||.||.||||.|',
    '|............|............|',
    '|.||||.|||||.|.|||||.||||.|',
    '|....|.......P.......|....|',
    '|||..|.||.|||||||.||.|..|||',
    '|......||....|....||......|',
    '|.||||||||||.|.||||||||||.|',
    '|.........................|',
    '|||||||||||||||||||||||||||'
]